const unsigned short overTLBush[] = {
 0xAEDF, 0xAEDF, 0xAEDF, 0xAEDF, 0xAEDF, 0xAEDF, 0xAEDF, 0xAEDF, 0xAEDF, 0xAEDF, 0xAEDF, 0xAEDF, 0xAEDF, 0xAEDF, 0x0540, 0x0540,
 0xAEDF, 0xAEDF, 0xAEDF, 0xAEDF, 0xAEDF, 0xAEDF, 0xAEDF, 0xAEDF, 0xAEDF, 0xAEDF, 0x0540, 0x0540, 0x0540, 0x0540, 0x0540, 0x0540,
 0xAEDF, 0xAEDF, 0xAEDF, 0xAEDF, 0xAEDF, 0xAEDF, 0xAEDF, 0xAEDF, 0xAEDF, 0x0540, 0x0540, 0x0540, 0x0540, 0x0540, 0x0540, 0x0540,
 0xAEDF, 0xAEDF, 0xAEDF, 0xAEDF, 0xAEDF, 0xAEDF, 0xAEDF, 0xAEDF, 0x0000, 0x0540, 0x0540, 0x0540, 0x0540, 0x0540, 0x0540, 0x0540,
 0xAEDF, 0xAEDF, 0xAEDF, 0xAEDF, 0xAEDF, 0xAEDF, 0xAEDF, 0xAEDF, 0x0000, 0x0000, 0x0540, 0x0000, 0x0000, 0x0000, 0x0540, 0x0540,
 0xAEDF, 0xAEDF, 0xAEDF, 0xAEDF, 0xAEDF, 0xAEDF, 0x0540, 0x0540, 0x0540, 0x0540, 0x0540, 0x0540, 0x0540, 0x0540, 0x0540, 0x0540,
 0xAEDF, 0xAEDF, 0xAEDF, 0xAEDF, 0x0000, 0x0540, 0x0540, 0x0540, 0x0540, 0x0540, 0x0540, 0x0540, 0x0000, 0x0000, 0x0000, 0x0000,
 0xAEDF, 0xAEDF, 0xAEDF, 0xAEDF, 0x0000, 0x0000, 0x0000, 0x0000, 0x0000, 0x0000, 0x0000, 0x0000, 0x0000, 0x0000, 0x0000, 0x0000,
 0xAEDF, 0xAEDF, 0x0540, 0xAEDF, 0xAEDF, 0xAEDF, 0xAEDF, 0x0000, 0x0540, 0x0540, 0x0540, 0xAEDF, 0x0000, 0x0540, 0x0000, 0x0000,
 0xAEDF, 0x0540, 0x0540, 0x0540, 0x0540, 0x0540, 0x0540, 0x0540, 0x0540, 0x0540, 0x0540, 0x0540, 0x0540, 0x0540, 0x0540, 0x0540,
 0x0540, 0x0540, 0x0540, 0x0540, 0x0540, 0x0540, 0x0540, 0x0540, 0x0540, 0x0540, 0x0540, 0x0540, 0x0540, 0x0540, 0x0540, 0x0000,
 0x0540, 0x0540, 0x0540, 0x0540, 0x0540, 0x0540, 0x0540, 0x0540, 0x0540, 0x0540, 0x0540, 0x0540, 0x0540, 0x0540, 0x0540, 0x0000,
 0x0000, 0x0540, 0x0540, 0x0540, 0x0540, 0x0540, 0x0540, 0x0540, 0x0540, 0x0540, 0x0540, 0x0540, 0x0540, 0x0540, 0x0540, 0x0540,
 0x0000, 0x0000, 0x0540, 0x0540, 0x0540, 0x0000, 0x0540, 0x0540, 0x0540, 0x0540, 0x0540, 0x0540, 0x0540, 0x0540, 0x0000, 0x0540,
 0xAEDF, 0x0000, 0x0000, 0x0000, 0x0000, 0x0000, 0x0000, 0x0000, 0x0540, 0x0540, 0x0000, 0x0000, 0x0000, 0x0000, 0x0000, 0x0000,
 0xAEDF, 0xAEDF, 0xAEDF, 0x0000, 0x0000, 0x0000, 0x0000, 0xAEDF, 0xAEDF, 0xAEDF, 0xAEDF, 0x0000, 0x0000, 0x0000, 0xAEDF, 0xAEDF,

};
